12 8
**333333333*
*33********3
33**3H3H***H
3**33***33*3
M**3*****3*B
33**PP**3**3
*3*****33**M
**333333***3